5 5 5 5 5 5 5 5 5 5 5 5 5 5 5 5 5 5 5 5 5 5 5 5 5
5 1 0 0 1 1 1 1 1 1 1 1 1 1 1 1 1 1 1 2 0 0 1 1 5
5 1 2 0 0 0 0 0 0 0 0 1 1 1 1 0 0 2 2 2 2 0 0 1 5
5 1 2 2 2 0 0 0 0 0 0 0 0 0 0 0 0 0 2 2 2 2 2 2 5
5 1 0 0 0 0 0 1 1 1 2 2 2 1 1 0 2 1 1 1 1 0 2 1 5
5 1 1 2 1 1 1 1 1 1 2 2 2 1 1 0 0 1 1 1 1 0 0 1 5
5 1 0 2 2 1 1 0 0 0 2 2 2 2 2 0 0 1 1 1 1 2 0 1 5
5 1 0 2 2 2 0 0 1 1 1 0 2 1 1 1 1 2 0 0 2 2 0 0 5
5 1 1 1 2 1 1 1 1 1 0 2 2 1 1 1 1 2 1 0 2 0 0 0 5
5 1 1 0 2 0 0 1 1 0 0 2 2 0 0 0 1 2 1 0 0 0 0 0 5
5 1 0 0 0 0 0 1 1 1 1 2 1 1 0 0 2 2 1 1 1 1 1 1 5
5 1 0 0 0 0 0 0 0 1 1 0 1 1 0 0 0 0 1 1 1 1 1 1 5
5 1 0 0 0 0 0 0 0 0 0 0 0 0 0 0 1 1 1 1 1 1 1 1 5
5 1 0 0 0 0 0 0 0 0 0 0 0 0 0 0 1 1 1 1 1 1 1 1 5
5 5 5 5 5 5 5 5 5 5 5 5 5 5 5 5 5 5 5 5 5 5 5 5 5
13 3
11 13